32 24 0
WWWWWWWWWWWWWWWWWWWWWWWWWWWWWWWW
W------------------------------W
W------------------------------W
W------------------------------W
W------------------------------W
W------------------------------W
W------------------------------W
W------------------------------W
W------------------------------W
W------------------------------W
W------------------------------W
W------------------------------W
--------------------------------
--X-----------------------------
--------------------------------
WWWWWWWWWWWWWWWWWWWWWWWWWWWWWWWW
W------------------------------W
W------------------------------W
W------------------------------W
W------------------------------W
W------------------------------W
W------------------------------W
W------------------------------W
W------------------------------W
0,12 1,15 - level 0=30,14
0,0 32,24 !1.1 text IS SOMEONE THERE?
10,0 32,24 - trigger 1.1=true
18,10 19,15 !1.2 text WHO ARE YOU?
18,10 19,15 - trigger 1.2=true
25,10 26,15 !1.3 text WELL, NEVERMIND
25,10 26,15 - trigger 1.3=true
31,12 32,15 - level 2