32 24 0
WWWWWWWWWWWWWWWWWWWWWWWWWWWWWWWW
W------------------------------W
W------------------------------W
W------------------------------W
W------------------------------W
W------------------------------W
W------------------------------W
W------------------------------W
W------------------------------W
W-----X------------------------W
W------------------------------W
W------------------------------W
W-------------------------------
W-------------------------------
W-------------------------------
W--------------WWW--WWWWWWWWWWWW
W-------------W--W--------------
W------------W----W-------------
W-----------W-----W-------------
W----------W-------W--WWWWWWWWWW
----------W--------W------------
---------W----------W-----------
--------W-----------W-----------
WWWWWWWWWWWWWWWWWWWWWWWWWWWWWWWW  
0,18 1,24 - exit 
22,10 32,15 - playertext PLAY
22,16 32,19 - playertext SETTINGS\n\n(UNDER CONSTRUCTION)\n
22,20 32,24 - playertext CREATORS
0,18 5,24 - playertext EXIT
31,12 32,15 - level 1
31,20 32,24 - level -1