32 24 3
W-------------------------------
W-------------------------------
W-------------W-------------WWWW
W-------WW----W--------------W--
W-------W-----W--------------W--
W-------W----WW-------------WW--
W-------W-----W--------------W--
W-------WW----W--------------W--
W-------W-----W-------------WW--
W-------W----WW--------------W--
W-------W-----W--------------W--
W-------WW----W-------------WW--
W-------W-----W--------------W--
W-------W----WW--------------W--
W-------W-----W-------------WW--
W-------WW----W--------------W--
W-------W-----W--------------W--
W-------W----WW-------------WW--
W-------W-----W--------------W--
W-------WW----W--------------W--
--------W-----W-------------WW--
--X----------WW--------------W--
--------------W--------------W--
WWWWWWWWWWWWWWWWWWWWWWWWWWWWWW--
0,20 0,24 - level 5
0,0 32,24 !6.1 text YOU DID IT AGAIN, RIGHT?
0,0 32,24 - trigger 6.1=true
13,12 14,13 !6.2 text ARE YOU SURE?
13,12 14,13 - trigger 6.2=true
1,3 8,4 - text YOU CAN'T BE THAT STUPID
14,0 15,2 - text ARE YOU REALLY SURE?
15,22 32,24 !6.3 text DO YOU WANT A SURPRISE?
15,23 32,24 - trigger 6.3=true
28,13 29,14 !6.4 text CAN YOU ASK YOURSELF\n ABOUT THAT?
28,13 29,14 - trigger 6.4=true
28,0 29,2 !6.5 text WHAT IS <THAT>?
28,0 29,2 - trigger 6.5=true
31,0 32,2 - level 7